C 																		0,255,0





F						 0,0,255
					NO 				./textures/ea_wall.xpm	
						SO ./textures/no_wall.xpm 
								WE 						./textures/so_wall.xpm	
													EA 				./textures/we_wall.xpm	


D ./textures/door.xpm


SP	./textures/1.xpm
SP	./textures/2.xpm
SP	./textures/3.xpm
SP	./textures/4.xpm
SP	./textures/5.xpm
SP	./textures/6.xpm
SP	./textures/7.xpm
SP	./textures/8.xpm
SP	./textures/9.xpm



111111111111
100000000001
100000000001
100000000001
100000000001
100000000001
100000000001
100000000001
100000000001111111111111
100000000000000000000001
100000000000000000000001
100000000000000000000001
11111111111D111111111111
100000000000000000000001
100000000000000000000001
100000000000000000000001
100000000000000000000001
100000000000000000000001
100000000000000000000001
100000000000000000000001
100000000000000000000001
100000N00000000000000001
100000000000000000000001
100000000000000000000001
100000000000000000000001
100000000000000000000001
100000000000000000000001
100000000000000000000001
100000000000000000000001
100000000000000000000001
1000000Y0000000000000001
100000000000000000000001
111111111111111111111111
