C 																		0,255,0

F						 0,0,255
					NO 				./textures/ea_wall.xpm	
						SO ./textures/no_wall.xpm 
								WE 						./textures/so_wall.xpm	
													EA 				./textures/we_wall.xpm	


    1111111111111111111111111
    1001100000000000000000001
    1110000000000000000010001
    1000000010000000000010001
    1000000110000000000000001
    1000000100000000000000001111111111111111111111
    1000001000000000000000000000000000000000000001
    1000000000011000000000000000000101100010000001
    1001110000000011000001101000000000000010000001
    10000000000001000000000001110000N0000001000001
    1000000000001000000000000000110000000000100001
    1000000000010000000010001111111111111111111111
    1000000010100000000110001
    1000000100000000000010001
    1000001000001000000000001
    1000000000011000000011001
    1000000001010000001010001
11111000000101000000100000001111111111111111111111
10000000010101000101000000000000000000000000000001
10000001010000000000000000000000000000000000000001
10000101001000001010000000101000000010010000000001
10010000000000010110000001100000010100000000000001
10000000000000000110001010000001010000000000000001
11111111111111111111111111111111111111111111111111
