C 																		225,30,0
F						 220,100,0
					NO 					./path_to_the_north_texture\ asdasdsad
						SO path_to_the_south_texture
								WE 									WE								./path_to_the_west_texture
													EA 																					./path_to_the_east_texture



11111111111
10000000001
111111111111111111111111
100100000000000000000000111111111
111111111011000001110000000000001
100000000011000001110111111111111
11110111111111011100000010001
11110111111111011101010010001
11000000110101011100000010001
10000000001000001100000010001
10000000000000001101010010001
11000001110101011111011110N01
11110111 1110101 101111010001
11111111 1111111 111111111111
