C 																		0,255,0





F						 0,0,255
					NO 				./textures/ea_wall.xpm	
						SO ./textures/no_wall.xpm 
								WE 						./textures/so_wall.xpm	
													EA 				./textures/we_wall.xpm	


D ./textures/door.xpm


SP	./textures/1.xpm
SP	./textures/2.xpm
SP	./textures/3.xpm
SP	./textures/4.xpm
SP	./textures/5.xpm
SP	./textures/6.xpm
SP	./textures/7.xpm
SP	./textures/8.xpm
SP	./textures/9.xpm
SP	./textures/11.xpm
SP	./textures/12.xpm
SP	./textures/13.xpm



1111111111111111111111
1000000000000000000001
111D111111111111111111
1000000000000000000001
111111111111111111D111
1000000000000000000001
11D1111111111111111111
1000000000000000000001
1111111111111111111D11111111111111
1000000000000000000000000000000001
11D1111111111111111111111111111111
1000000000000000000000000000000001
111111111111111111111D111111111111
100000000000000000000000000000000111111111111111111111111111
100000000000000000000000000000000010001000100000000000000001
100001000000000000000000000000000010101010100000000000000001
10001 100000000000000000000000000010101010100000000000000001
100001000000000000000000000000000010101010100000000000000001
100000000000000000000000000000000000100010000000000000000001
100000000000000000000000000000000111111111111111110000000001
1000000000000000N00000000000000001               10000000001
1000000000000000000000000000000001               10000000001
1000000000000000000000000000000001               11D11111D11
1000000000000000000000000000000001               10000000001
1111111111111111111111000001000001               10000000001
1000000000000000000000000001000001               1000Y000001
1000000000000000000000000001000001               10000000001
1000111111111110000000000001000001               10000000001
1000100000000010000000000011000001               11111111111
1000100000000011111111111110000001
1000100000000000000000000000000001
1000100000000000000000000000000001
1111111111111111111111111111111111
